00000000000000000000000000000000
00000000000000000000000000000000
00000000000000000000000000000000
00000030000000000000000000000000
00001111100000000000000000000000
00000000000000000000000000000000
00000030000000000000000000000000
00011111110000000000000000000000
00000000000000000000300000000000
00000000000000000011111000000001
11111111111111000122222110300112
22222222222222000222222221111222